11111111111111
1s101010100001
10101010101001
10000010101001
11111010101001
10010010101001
100000000010f1
11111111111111
